NO ./path_to_the_north_texture
SO ./path_to_the_south_texture
WE ./path_to_the_west_texture
EA ./path_to_the_east_texture
F 220,100,0
C 225,30,0
             1111111
             1     1    11
             1     1   1 01
        111111     111111111
        10000000000000000001
        1                  1
        1           N      1
        1                  1
        1                  1
   1    1   111  111  111 11
   1    1   111  111  111 11
   1    1   111  111  111 11
   1    1   111  111  111 11
